empty 32x32
99:99
story_lines 2
this is an empty template map
for building on. size 32x32 tiles.
0
0
facings 32x32
NNNNNNNNNNNNNNNNNNNNNNNNNNNNNNNN
NNNNNNNNNNNNNNNNNNNNNNNNNNNNNNNN
NNNNNNNNNNNNNNNNNNNNNNNNNNNNNNNN
NNNNNNNNNNNNNNNNNNNNNNNNNNNNNNNN
NNNNNNNNNNNNNNNNNNNNNNNNNNNNNNNN
NNNNNNNNNNNNNNNNNNNNNNNNNNNNNNNN
NNNNNNNNNNNNNNNNNNNNNNNNNNNNNNNN
NNNNNNNNNNNNNNNNNNNNNNNNNNNNNNNN
NNNNNNNNNNNNNNNNNNNNNNNNNNNNNNNN
NNNNNNNNNNNNNNNNNNNNNNNNNNNNNNNN
NNNNNNNNNNNNNNNNNNNNNNNNNNNNNNNN
NNNNNNNNNNNNNNNNNNNNNNNNNNNNNNNN
NNNNNNNNNNNNNNNNNNNNNNNNNNNNNNNN
NNNNNNNNNNNNNNNNNNNNNNNNNNNNNNNN
NNNNNNNNNNNNNNNNNNNNNNNNNNNNNNNN
NNNNNNNNNNNNNNNNNNNNNNNNNNNNNNNN
NNNNNNNNNNNNNNNNNNNNNNNNNNNNNNNN
NNNNNNNNNNNNNNNNNNNNNNNNNNNNNNNN
NNNNNNNNNNNNNNNNNNNNNNNNNNNNNNNN
NNNNNNNNNNNNNNNNNNNNNNNNNNNNNNNN
NNNNNNNNNNNNNNNNNNNNNNNNNNNNNNNN
NNNNNNNNNNNNNNNNNNNNNNNNNNNNNNNN
NNNNNNNNNNNNNNNNNNNNNNNNNNNNNNNN
NNNNNNNNNNNNNNNNNNNNNNNNNNNNNNNN
NNNNNNNNNNNNNNNNNNNNNNNNNNNNNNNN
NNNNNNNNNNNNNNNNNNNNNNNNNNNNNNNN
NNNNNNNNNNNNNNNNNNNNNNNNNNNNNNNN
NNNNNNNNNNNNNNNNNNNNNNNNNNNNNNNN
NNNNNNNNNNNNNNNNNNNNNNNNNNNNNNNN
NNNNNNNNNNNNNNNNNNNNNNNNNNNNNNNN
NNNNNNNNNNNNNNNNNNNNNNNNNNNNNNNN
NNNNNNNNNNNNNNNNNNNNNNNNNNNNNNNN
textures 32x32
cccccccccccccccccccccccccccccccc
cccccccccccccccccccccccccccccccc
cccccccccccccccccccccccccccccccc
cccccccccccccccccccccccccccccccc
cccccccccccccccccccccccccccccccc
cccccccccccccccccccccccccccccccc
cccccccccccccccccccccccccccccccc
cccccccccccccccccccccccccccccccc
cccccccccccccccccccccccccccccccc
cccccccccccccccccccccccccccccccc
cccccccccccccccccccccccccccccccc
cccccccccccccccccccccccccccccccc
cccccccccccccccccccccccccccccccc
cccccccccccccccccccccccccccccccc
cccccccccccccccccccccccccccccccc
cccccccccccccccccccccccccccccccc
cccccccccccccccccccccccccccccccc
cccccccccccccccccccccccccccccccc
cccccccccccccccccccccccccccccccc
cccccccccccccccccccccccccccccccc
cccccccccccccccccccccccccccccccc
cccccccccccccccccccccccccccccccc
cccccccccccccccccccccccccccccccc
cccccccccccccccccccccccccccccccc
cccccccccccccccccccccccccccccccc
cccccccccccccccccccccccccccccccc
cccccccccccccccccccccccccccccccc
cccccccccccccccccccccccccccccccc
cccccccccccccccccccccccccccccccc
cccccccccccccccccccccccccccccccc
cccccccccccccccccccccccccccccccc
cccccccccccccccccccccccccccccccc
types 32x32
00000000000000000000000000000000
00000000000000000000000000000000
00000000000000000000000000000000
00000000000000000000000000000000
00000000000000000000000000000000
00000000000000000000000000000000
00000000000000000000000000000000
00000000000000000000000000000000
00000000000000000000000000000000
00000000000000000000000000000000
00000000000000000000000000000000
00000000000000000000000000000000
00000000000000000000000000000000
00000000000000000000000000000000
00000000000000000000000000000000
00000000000000000000000000000000
00000000000000000000000000000000
00000000000000000000000000000000
00000000000000000000000000000000
00000000000000000000000000000000
00000000000000000000000000000000
00000000000000000000000000000000
00000000000000000000000000000000
00000000000000000000000000000000
00000000000000000000000000000000
00000000000000000000000000000000
00000000000000000000000000000000
00000000000000000000000000000000
00000000000000000000000000000000
00000000000000000000000000000000
00000000000000000000000000000000
00000000000000000000000000000000
heights 32x32
88888888888888888888888888888888
88888888888888888888888888888888
88888888888888888888888888888888
88888888888888888888888888888888
88888888888888888888888888888888
88888888888888888888888888888888
88888888888888888888888888888888
88888888888888888888888888888888
88888888888888888888888888888888
88888888888888888888888888888888
88888888888888888888888888888888
88888888888888888888888888888888
88888888888888888888888888888888
88888888888888888888888888888888
88888888888888888888888888888888
88888888888888888888888888888888
88888888888888888888888888888888
88888888888888888888888888888888
88888888888888888888888888888888
88888888888888888888888888888888
88888888888888888888888888888888
88888888888888888888888888888888
88888888888888888888888888888888
88888888888888888888888888888888
88888888888888888888888888888888
88888888888888888888888888888888
88888888888888888888888888888888
88888888888888888888888888888888
88888888888888888888888888888888
88888888888888888888888888888888
88888888888888888888888888888888
88888888888888888888888888888888
dm textures/anton2_dm.png
sm textures/anton2_sm.png
props 0 # script uv h f rx tx
chars 1 # script u,v heading
crongdor.character 5,5 270
amb_snds 0 # f u,v h r
popups 6
2 (0.8 0.2 0.2 0.8) LOOK OUT! BOULDER TRAP!
0 (1 1 1 1) some textnew!!!
3 (0 1 0 1) crondor saw the stairs\nturn north and to the east\nand drew his sword as he aproached
4 (0 1 0 1) as stealthily as a panther\ncrongdor crept acros the rooftops
5 (0 1 0 1) crongdor drew his sword\nand entered the alleyway
6 (0 1 0 1) crongdor knew well the\nadvantage of travelling higher up\nthan his enemies expected...
